W,-,W,-,W,-,W,-,W,-,W,-,W,-,W,-,W,-,W,-,W,-,W,-,W,-,W,-,W,-,W,-,W,-,W,-,W,-,W,-,W,-,W,-,W,-,W,-,W,
-,-,-,-,-,-,-,-,-,-,-,-,-,-,-,-,-,-,-,-,-,-,-,-,-,-,-,-,-,-,-,-,-,-,-,-,-,-,-,-,-,-,-,-,-,-,-,-,-,
W,-,W,-,W,-,W,-,W,-,W,-,W,-,W,-,W,-,W,-,W,-,W,-,W,-,W,-,W,-,W,-,W,-,W,-,W,-,W,-,W,-,W,-,W,-,W,-,W,
-,-,-,-,-,-,-,-,-,-,-,-,-,-,-,-,-,-,-,-,-,-,-,W,-,-,-,-,-,-,-,-,-,-,-,-,-,-,-,-,-,-,-,-,-,-,-,-,-,
-,-,-,-,-,-,-,-,-,-,-,-,-,-,-,-,-,-,-,-,-,-,-,W,-,-,-,-,-,-,-,-,-,-,-,-,-,-,-,-,-,-,-,-,-,-,-,-,-,
-,-,-,-,-,-,-,-,-,-,-,-,-,-,-,-,-,-,-,-,-,-,-,-,-,-,-,-,-,-,-,-,-,-,-,-,-,-,-,-,-,-,-,-,-,-,-,-,-,
-,-,-,-,-,-,-,-,-,-,-,-,-,-,-,-,-,-,-,-,-,-,-,-,-,-,-,-,-,-,-,-,-,-,-,-,-,-,-,-,-,W,-,-,-,-,-,-,-,
-,-,-,-,-,-,-,G,G,G,G,G,G,G,-,-,-,-,-,-,-,-,-,-,-,-,-,-,-,-,-,-,-,-,-,-,-,-,-,-,-,W,-,-,-,-,-,-,-,
-,-,-,-,-,-,-,G,G,G,G,G,G,G,-,-,-,-,-,-,-,-,-,-,-,-,-,-,-,-,-,-,-,-,-,-,-,-,-,-,-,W,-,-,-,-,-,-,-,
-,-,-,-,-,-,-,G,G,G,-,-,-,-,-,-,-,-,-,-,-,-,-,W,-,-,-,-,-,-,-,-,-,-,-,-,-,-,-,-,-,W,-,-,-,-,-,-,-,
-,-,-,-,-,-,-,G,G,G,-,-,-,-,-,-,-,-,-,-,-,-,-,W,-,-,-,-,-,-,-,P,-,-,-,-,-,-,-,-,-,W,-,-,-,-,-,-,-,
-,-,-,-,-,-,-,G,G,G,-,-,-,-,-,-,-,-,-,-,-,-,-,W,-,-,-,-,-,-,-,-,-,-,-,-,-,-,-,-,-,W,-,-,-,-,-,-,-,
-,-,-,-,-,-,-,G,G,G,-,-,-,-,-,-,-,-,-,-,-,-,-,W,-,-,-,-,-,-,-,-,-,-,-,-,-,-,-,-,-,W,-,-,-,-,-,-,-,
-,-,-,-,-,-,-,G,G,G,-,-,-,-,-,-,-,-,-,-,-,-,-,W,-,W,-,W,-,-,-,-,-,-,-,-,-,-,-,-,-,W,-,-,-,-,-,-,-,
-,-,-,-,-,-,-,G,G,G,-,-,-,-,-,-,-,-,-,-,-,-,-,W,-,-,-,W,-,-,-,-,-,-,-,-,-,-,-,-,-,W,-,-,-,-,-,-,-,
-,-,-,-,-,-,-,G,G,G,-,-,-,-,-,-,-,-,-,-,-,-,-,W,-,-,-,W,-,-,-,-,-,-,-,-,-,-,-,-,-,W,-,-,-,-,-,-,-,
-,L,M,M,M,M,M,M,M,M,M,M,M,M,M,M,M,M,M,M,M,M,R,W,-,-,-,W,-,-,-,W,-,W,-,W,-,W,-,-,-,-,-,-,-,-,-,-,-,
-,-,-,-,-,-,-,-,-,-,-,-,-,-,-,-,-,-,-,-,-,-,-,-,-,-,-,-,-,-,-,-,-,-,-,-,-,-,-,-,-,-,-,-,-,-,-,-,-,
-,-,-,-,-,-,-,-,-,-,-,-,-,-,-,-,-,-,-,-,-,-,-,-,-,-,-,-,-,-,-,-,-,-,-,-,-,-,-,-,-,-,-,-,-,-,-,-,-,
-,-,-,-,-,-,-,-,-,-,-,-,-,-,-,-,-,-,-,-,-,-,-,-,-,-,-,-,-,-,-,-,-,-,-,-,-,-,-,-,-,-,-,-,-,-,-,-,-,
-,-,-,-,-,-,-,-,-,-,-,-,-,-,-,-,-,-,-,-,-,-,-,-,-,-,-,-,-,-,-,-,-,-,-,-,-,-,-,-,-,-,-,-,-,-,-,-,-,
-,-,-,-,-,-,-,-,-,-,-,-,-,-,-,-,-,-,-,-,-,-,-,-,-,-,-,-,-,-,-,-,-,-,-,-,-,-,-,-,-,-,-,-,-,-,-,-,-,
-,-,-,-,-,-,-,-,-,-,-,-,-,-,-,-,-,-,-,-,-,-,-,-,-,-,-,-,-,-,-,-,-,-,-,-,-,-,-,-,-,-,-,-,-,-,-,-,-,
-,-,-,-,-,-,-,-,-,-,-,-,-,-,-,-,-,-,-,-,-,-,-,-,-,-,-,-,-,-,-,-,-,-,-,-,-,-,-,-,-,-,-,-,-,-,-,-,-,
W,-,W,-,W,-,W,-,W,-,W,-,W,-,W,-,W,-,W,-,W,-,W,-,W,-,W,-,W,-,W,-,W,-,W,-,W,-,W,-,W,-,W,-,W,-,W,-,W,
-,-,-,-,-,-,-,-,-,-,-,-,-,-,-,-,-,-,-,-,-,-,-,-,-,-,-,-,-,-,-,-,-,-,-,-,-,-,-,-,-,-,-,-,-,-,-,-,-,
W,-,W,-,W,-,W,-,W,-,W,-,W,-,W,-,W,-,W,-,W,-,W,-,W,-,W,-,W,-,W,-,W,-,W,-,W,-,W,-,W,-,W,-,W,-,W,-,W,
